
Andvarafors: waterfall of Andvari
Ása Ásum Æsirnir Æsir
Ásgarði

Brávelli: Brávöllr (place in Asgard)
Busiltjörn: Busiltjörn # river

Danmörk: Danmörku Danmörk # Denmark

Fjóni: Fjóni # Fyn
Frakkland: Frakklands

Garða(konungi): Russland
Gautland: Gautland Gautlands Gautlandi # Gautland
Gnitaheiðr: Gnitaheiðr Gnitaheiði # where Fafnir lives
Gnípalundr: Gnípalundi # port
Grikkland: Grikklands
Grind: Grindum # place

Heðinsey: Heðinsey #
Hindarfjall : Hindarfjall # La montage de la biche
Hlymdalir: Hlymdali # where Gunnar, Högni and Sigurd ride
Hringstaði: Ringsted in Denmark
Húnaland: Húnaland Húnalandi # country of the Huns
Hýnir: Hýnir # Huns

Láganes: Láganesi #

Norðrlöndum: Norðrlöndum # Gibraltar detroit
Nörvasundum: Nörvasundum #

Óskaptr: Óskaptr # the not created

Rauðabjarg: Rauðabjarga #
Rín: Rín # Rhein

Sök: Sök # island
Sólfjöll: Sólfjöll # where Granmarr and Hödhbrodhr fought
Svarinshaugr: Svarinshaugi #

Valbjörg: Valbjörg
Vínbjörg: Vínbjörg
Varinsey: Varinsey #
Varinsfjörðr: Varinsfjörðr #
Víkingr: Víkingar # Vikings

Þrasnes: Þrasnesi #
