Aaron: Aaron
Amon: Amon
Abbacuc: Abbacuc
Abel: Abel
Abia: Abia # Abias
Abiti: Abiti # Avitus
Abiud: Abiud # Abioud
Abraham: Abraham
Abrincatis: Abrincatis # Avranches
Aprunculus: Aprunculo Aprunculus Aprunculi Abrunculus
Absalonem: Absalonem Absolonem # Absalon
# Absculta: Absculta (absculto)
# Absistete: Absistete
Acaunos: Acaunos Acaunensim Acaunenses Acaunensium # Aucane
Achaz: Achaz
Achim: Achim
Adam: Adam
Adovacrius: Adovario Adovacrius Adovarius Adovacrio Odovacrius # Adovaire
# Adpraehensum: Adpraehensam Adpraehensum
Adrianus: Adrianus Adriano
# Adsteterunt: Adsteterunt
# Adtendete: Adtendete
Aeclesiae: Aeclesiae
Aecolinensis: Aecolinensis
Aegipto: Aegipto Aegyptu Aegyptum Aegyptiorum Aegyptiarum Aegypti Aegyptiis Aegyptio Aegyptiorum Aegyptios Aegyptius Aegypto Aegyptum
Aegylanis: Aegylanis
Aepulantibus: Aepulantibus
Aetaliae: Aetaliae
Aetherius: Aetherius Aetherium Aetherio
Aetius: Aetium Aetius Aeti Aetii Aetio
Africa: Africa Africae Africam Africanum
Agasastus: Agasastus
Agatadis: Agatadis
Agathensi: Agathensi Agathensis Agathae
Agenninsis: Agenninsis Agennensibus
Agericus: Agericum Agericus Agerici Agerico Agiricus
Agila: Agila
Agilane: Agilane Agilanem
Aginus: Aginum Aginnum # Aginus, dux
Agyno: Agyno
Agne: Agne Agni Agnis
Agnitem: Agnitem Agnite
Agripinam: Agripinam Agrepinam
Agricius: Agricium
Agrippinensi: Agrippinensi Agripinensim
Agricolae: Agricolae
Agroecula: Agroecula Agroecola Agroeculae
Agroetius: Agroetius
Agustus: Agusti Agustus Augustum Augusto Augusti
Agustidunensi: Agustidunensi Agustidunensim Agustidunensis
Agustidunum: Agustidunum
Alamannus: Alamannus Alamanni Alamannos Alamannis Alamannorum
Alanos: Alanos Alanis Alanorum
Alaricum: Alaricum Alarici Alarico Alaricus
Albige: Albige Albigae Albigensis Albiginsem Albigensim Albigensem Albigense Albiginsibus # Albi
Albinus: Albinus Alboenus Albini Albinum
Alboeno: Alboeno Alboeni
Albofledis: Albofledis
Alchima: Alchima
Alexandri: Alexandri
Alingaviensi: Alingaviensi
Alioquin: Alioquin
Alithium: Alithium
Amalaberga: Amalaberga
Amalaricum: Amalarici Amalaricum Amalarico Amalaricus
Ambaciensi: Ambaciensi Ambaciensim # Amboise
Ambrosium: Ambrosium Ambrosii Ambrosio
Amelius: Amelio Amalo Amelius
Amalonis: Amalonis
# Ambolavit: Ambolavit # alla
Aminadab: Aminadab
Ampsivariis: Ampsivariis
Anastasius: Anastasius Anastasio
Anatholius: Anatholius
Andarchius: Andarchi Andarchius Andarci
Andecavus: Andecavi Andecavam Andecavus Andecavo Andecavos Andecavum Andecavis Andecavae
Andegavensis: Andegavensis Andecavensis
Andigavus: Andegavis Andigavam Andigavus
Andelao: Andelao
Andreae: Andreae
Aniani: Aniani
Anicium: Anicium
Animodi: Animodi
Aninsola: Aninsola
Annaniae: Annaniae Annaniam
Annianus: Annianus
Ansovaldus: Ansovaldus Ansovaldum Ansovaldo
Antechristus: Antechristus Antechristum
Antestius: Antestius Antestio
Anthiocia: Anthiocenae Anthiocia Anthiociae
Anthiocensis: Anthiocensis Anthyocinsis
Anthiocinus: Anthiocinus Anthiochino
Antidio: Antidio
Antolianus: Antolianus
Antoninus: Antonini # Antonin
Antonius: Antonius Antonii # Antoine
Aunulfo: Aunulfo
Apamiae: Apamiae
Apocalipsim: Apocalipsim
Apollonari: Apollonari Apollinare Apollonaris Apollonarem
Aptacharius: Aptacharius Aptacharium Aunacharius
Aquensim: Aquensim Aquinsi
Aquileia: Aquileia Aquileiam
Aquinsibus: Aquinsibus
Aram: Aram
Arareca: Ararem Arareca
Aravatius: Aravatio Aravatius
Arbogastis: Arbogastis
Archadium: Archadium Archadii Archadius Arcadi
Ardoennensis: Ardoennensis
Aredium: Aredium Aredii Aredius
Aregisilus: Aregisilus Aregisilum Aregisili
Aregundis: Aregundis Aregundem
Arelate: Aetium
Arelatense: Arelatense Arelatensim Arilatensim Arelatensis Arelatinsim Arelatinsi
Arelatensibus: Arelatensibus
Areptis: Areptis
Argentum: Argentum
Argentoratinsim: Argentoratinsim
Argivus: Argivus Argeus
Aridi: Aridi Aridio
Arietis: Arietis
Ariolus: Ariolus
Arisitensim: Arisitensim
Armentium: Armentium Armentius Armentarius?
Arminia: Arminia Arminiorum
Arnegysilo: Arnegysilo
Arphaxath: Arphaxath
Arriana: Arriana Arrianae
Arriano: Arriano Arriani Arrianorum
Arrius: Arrium Arrius Arrii
Artemius: Artemius Arthemio Artemium
Asterius: Asterius
Arvernus: Arvernam Arvernus Arverni Arverna Arverno Arverne Arvernum Arvernis Arvernae Arvernorum
Asa: Asa
Asclipius: Asclipius
Ascovindum: Ascovindum
Ascylam: Ascylam
Aser: Aser
Asia: Asia
Assirios: Assirios
Asteriolus: Asteriolus Asteriolum Asteriolo
Athalocus: Athalocus
Athanagilde: Athanagilde Athanachilde
Athanaeldo: Athanaeldo Athanaeldi
Athanagildus: Athanagildus
Athanaricus: Athanarici Athanarico Athanaricus
Athiniensibus: Athiniensibus
Attalus: Attalus Attalum Attali Attalo
Attica: Attica Attico
Attila: Attila Attela Attilanem
Audica: Audica
Audini: Audini Audino
Audisiodorensim: Audisiodorensim Audisiodorensis
Axonam: Axonam
Audonem: Audonem
Audovaldus: Audovaldus
Audovera: Audovera Audoveo
Aunone: Aunone
Aurilianensium: Aurilianensim Aurilianensem Aurilianensis Aurilianinsim Aurilianensium Aurilianense
Aurilianensibus: Aurilianensibus
Aurilianus: Aurilianis Aurilianus
Aurilio: Aurilio Auriliano
Austadius: Austadius Ausanius Eustasius
Auscensis: Auscensis Ausciensim
Austerchilde: Austerchilde
Austrapius: Austrapius Austrasiis Austrapio
Austrigilde: Austrigilde Austregildem Austrigildis
Austrighyselus: Austrighyselus Austrighyselum Austrighyselo
Austrinus: Austrinus
Austrovaldus: Austrovaldo Austrovaldus
Avalocium: Avalocium
Avenniensis: Avenniensis
Avennica: Avennico Avennica Avennicae Avennici Avennecam Avennicam Avennicorum
Avinionem: Avinionem Avenione Avennionem Avennione
Avennica: Avennico Avennica Avennicae Avennici Avennecam Avennicam Avennicorum
Avonem: Avonem
Azor: Azor
Babel: Babel
Babillas: Babillas Bobillam
Babillonia: Babillonia Babiloniam Babilonia
Baddo: Baddo Waddo
Baddonem: Baddonem Waddonis Waddonem Waldonem Baddone Waddone
Beregisilum: Beregisilum Badegisilum
Baudegysili: Baudegysili Badegyseli
Baudegyselus: Baudegyselus Badegysilus
Badericus: Badericus Baderico
Bodigysilo: Bodigysilo Badigysili
Baiocassini: Baiocassini Baiocassinos Baiocassino
Balatedine: Balatedine
Ballomerem: Ballomerem
Basilius: Basilius Basilii Basilium
Bysinum: Bysinum Basinae Basina Basinam
Baudinus: Baudinus
Begorra: Begorra
Helia: Heliae Helia Belial
Belphegor: Belphegor
Belsephon: Belsephon
Belsonancum: Belsonancum Belsonanco
Belsuarius: Belsuarius Belsuarium
Benarnae: Benarnae Benarno
Beniamin: Beniamin Beneamen
Benigni: Benigni
Beorretanae: Beorretanae
Beppolini: Beppolini Beppoleno
Beppolenus: Beppolenus Bippolinus Pappolenus Beppolenum Byppolenus
Beretrudis: Beretrudis
Berrao: Berrao Vernao
Berravensis: Berravensis
Bersabee: Bersabee
Berthchramnum: Berthchramnum Berthchramnus Berthramnus Berthechramnus Bertchramnus Bertchramnum Bertechramnus
Bertecharii: Bertecharii
Berthechramni: Berthechramni Berthchramno Berthramno Bertechramno
Berthefredus: Berthefledis Berthefredi Berthefredus Bertefredus Berthefredo Berthefredum
Bertegundis: Bertegundis Berthegundis
Berthacharium: Berthacharium Berthacharius
Berulfus: Berulfus Berulfo
Bethleem: Bethleem
Betoricum: Betoricum Bitoricum
Beturigum: Biturigi Beturigum Biturigo Bituricas Bitoricas Biturigae Bituricam Biturigis Bitorigus Bitorigo Biturigum Biturigas Byturigi Bituriga Biturigus Bituricae Beturica
Bilitionem: Bilitionem
Biterrensim: Biterrensim
Biterris: Biterris
Bitorex: Bitorex
Bladastis: Bladastis Bladasti
Blesensibus: Blesensis Blesensibus
Boantum: Boantum Boanti
Booz: Booz Boso Bobo
Boboleni: Boboleni Boboleno
Bobone: Bobone Bosonem Bosone Bosonis
Godinus: Godinus Bodicus
Bodigysilus: Bodigysilus Bodygisilus
Brachione: Brachione Brachio?
Brannacum: Brannacum Brinnacum Brinnaco
Bricca: Bricca
Bricteros: Bricteros
Brictium: Brictium Brictii Brictio Brictius
Brictionem: Brictionem
Brinctanorum: Brinctanorum Brittanorum
Brinnacinsis: Brinnacinsis
Briotreide: Briotreide # Bléré
Brittanus: Brittaniam Brittanis Britiani Brittaniis Brittanus Brittanos Brittanias Brittaniae Brittani Brittania
Britto: Britto Brittone
Briva-Curretia: Briva-Curretia
Brivam: Brivam Brivate
Brivatensim: Brivatensim Brivatinsem
Brixis: Brixis
Brunichilde: Brunichilde Brunechilde Brunichildem Brunechildis Brunichildes Brunichildis Brunechildem
Buccelenum: Buccelenum Buccelenus
Bucciovaldus: Bucciovaldo Bucciovaldus
Buccus: Buccus
Buconiam: Buconiam
Bulgiatensim: Bulgiatensim
Burdegala: Burdegala Burdigale
Burdigalinsis: Burdigalinsis Burdegalinsem Burdigalensis Burdegalensi Burdigalensim Burdigalinsi Burdegalensem Burdegalinsis Burdigalense Burdegalensim Burdegalensis Burdigalinsim
Burdegalensibus: Burdegalensibus
Burgolenus: Burgolenus
Burgolini: Burgolini Burgulini
Burgundionum: Burgundiones Burgondiones Burgundione Burgundionis Burgundionum Burgundionibus
Burgundia: Burgundias Burgundiam Burgundiae Burgundia Burgundio
# CCCCXII: CCCCXII
# CXCVII: CXCVII CXII CCXLII
Cabillonnensis: Cabillonnensis
Cavellonum: Cabillonno Cavellonum Cabillonum Cavillonum Cavillonno
Cadurcinsis: Cadurcinsis Cadurcensis Cadurcinis
Catulus: Catulus
Caturcinae: Caturcinae Cadurcinae
Cadurcus: Cadurcus Cadurcorum Cadurcum Cadurcis Cadurcinum
# Caeciderunt: Caeciderunt # verbe
Caecros: Caecros # Cecrops
Caenomannensis: Caenomannensis
Caenomannicae: Caenomannicae Caenomannici
Caesar: Caesar Caesaris Caesariensis Caesarii Caesario
Caesaragustanam: Caesaragustanam
Caesaraugustae: Caesaraugustae
Casaria: Caesariam Caprariam Casariae Casaria Caesariae Caesariamquae Caesariensis # Césarée
Cain: Cain
Cainan: Cainone Cainan Caino Cainonensem Cainoninse # Chinon
Cham: Cham Calam
Calatonno: Calatonno
Calensi: Calensi Calensim Dolensim
Calliciense: Calliciense Calliciensibus
Calmes: Calmes
Calomniosi: Calomniosi
Caluppa: Caluppa Caluppane
Calvariae: Calvariae #Calvaire
Camaracense: Camaracense
Camaracum: Camaracum
Campanensis: Campanensis
Campania: Campania Campaniae
Canaonem: Canaonem
Cantabennensi: Cantabennensi
Ganthia: Ganthia Canthia
Cantobennici: Cantobennici
Capitulium: Capitulium Capitulio
Caprasi: Caprasi
Carbonariam: Carbonariam
Carcasonam: Carcasonam
Carcasonensibus: Carcasonensibus
Cares: Cares
Carietto: Carietto
Carnotena: Carnotinae Carnotino Carnotenae Carnotena
Carnotenum: Carnotenum Carnotenis Carnotensim Carnotenorum
Carpilionis: Carpilionis
Carpitania: Carpitaniam Carpitania
Cartaginem: Cartaginem
Cartaginensis: Cartaginensis Chartaginensis
Carthaginensibus: Carthaginensibus
Cartherio: Cartherio
Cassius: Cassius Cassii Cassium
Cassiani: Cassiani
Castinus: Cautino Castinus Cautinus Cautini Cautinum
Catalaunensis: Catalaunensis
Catianus: Catianus Catiani
Cato: Cato Catonem Catone Catonis Catoni
Catthis: Catthis
Cautum: Cautum
Cavillonensim: Cavillonensim Cavellionensim
Cavelonensis: Cavelonensis
Celsus: Celsum Celsi
Cencris: Cencris
Cenomanicos: Cenomanicos
Cenomannorum: Cenomannorum Cinomannorum
Cerate: Cerate
Ceresium: Ceresium
Cessantebus: Cessantebus
Chamavi: Chamavi
Chanaone: Chanaone Chanaan Chanao
Chararicus: Chararicus Chararici Chararicum
Charegyselus: Charegyselus
Chariberthus: Chariberthi Chariberthus Charibertho Charibertum Chariberthum
Charimerem: Charimerem
Chariulfus: Chariulfo Chariulfus
Charivaldus: Charivaldus
Charteri: Charteri
Chedinus: Chedinus Chrodinus
Childeberthus: Childeberthus Childeberthi Childeberti Childebertum Childeberto Childeberthum Childebertus Childebertho Childiberthus
Cilicium: Cilicium
Chilperico: Chilperico Chulderici Childerico Chilperici Chulderico
Chilpericum: Chilpericum Chlodericus Childericus Chlodericum Chuldericus Chilpericus Childericum
Chlochilaichum: Chlochilaichum
Chlodomere: Chlodomere Chlodomeris Chlodomerem Chlodemeris
Chlodoberthum: Chlodoberthum Chlodoberthus
Chlodosinda: Chlodosuindam Chlodosinda Chlodosuinda
Chlodovaldus: Chlodovaldus Chlodovaldum
Chlodovechus: Chlodovechus Chlodovechi Chlodovechum Chlodovecho
Chlogio: Chlogio
Chlogionem: Chlogionem
Chlotharius: Chlotharii Chlotharius Chlotchari Chlotharium Chlothari Chlothario
Chlotchildem: Chlotchildem
Chlothacharius: Chlothachario Chlothacharius Chlothacharii Chlothacharium Chlothachari
Chlothiheldae: Chlothiheldae
Chlothosinda: Chlothosindam Chlothosinda Chlothsindam
Chlotlhrii: Chlotlhrii
Chonomorem: Chonomorem
Chonoober: Chonoober Chonoobro
Chramisindus: Chramisindo Chramisindi Chramisindus
Chramnesindus: Chramnesindi Chramnesindus
Chramnum: Chramnum Chramno Chramni Chramnus
Christus: Christus Christe Christum Christo Christiani Christi
Cristoforus: Cristofori Cristoforus Christofori
Chrocus: Chrocus Chroco
Chrotchilde: Chrotchilde Chrodechilde
Chrodichildis: Chrodichildis Chrodechildis Chrotchildis
Chrodielde: Chrodielde Chrodieldes Chrodieldis Chrodieldae Chrodieldem
Chrodigilde: Chrodigilde Chrodigildis
Chrodini: Chrodini
Chrononensim: Chrononensim
Chunus: Chunus Chus Chunis Chuni Chundo Chunos Chunorum # Huns
Chundonem: Chundonem Chundonis
Chunsinam: Chunsinam
Chuppa: Chuppa Chuppanem Chuppani
Cinnomannicum: Cinnomannicum
Cinomanensim: Cinomanensim
Cinomannica: Cinomannis Cinomannica Cinomannico Cinomannicis
Crona: Crona Cyrola Cirola
Cisomagensi: Cisomagensi
Ciucilonem: Ciucilonem
Claram: Claram
Claudius: Claudi Claudii Claudius Claudio Claudium
Clauso: Clauso Clausis
Clavati: Clavati
Clemens: Clemens Clementis
Clenni: Clenni
Cleuphe: Cleuphe
Clysma: Clysma
Colonia: Colonia Coloniae # Cologne (Agrippinensi)
Cognuscemus: Cognuscemus
# Collicto: Collicto
Colomna: Colomnam Colomna
Condatinsem: Condatinsem Condatensi Condatensim Condatensis
Condidirat: Condidirat
Confabulantibus: Confabulantibus
Confligentis: Confligentis
# Congerete: Congerete
Conpraessa: Conpraessa
Consolaribus: Consolaribus
Constans: Constantis Constantio Constans Constante Constantium # Constance
Constantinus: Constantinus Constantini Constantinis # Constantin
Constantinam: Constantinam Constantinae
Constantinopuli: Constantinopuli Constantinopoli Constantinopolim Constantinopolitanam
Convenassic: Convenassic
Convenicae: Convenicae
Corinthiis: Corinthiis # Corinthe
Cornilius: Cornilius
Cornutium: Cornutium
Cotiam: Cotiam Cothiam
Cotidiae: Cotidiae
Crededit: Crededit
Crispum: Crispum
Crispini: Crispini
Crispiniani: Crispiniani
Cummotu: Cummotu Cummoto
Cyces: Cyces
Cymulum: Cymulum
Cyprianus: Cyprianus
Dacco: Dacco
Dacconis: Dacconis
Dagarici: Dagarici
Dagulfus: Dagulfus
Dalmatius: Dalmatius Dalmatii Dalmatio
Damiani: Damiani
Dan: Dan
Dani: Dani # Danois
Danihel: Danihel
Daulfi: Daulfi
David: David
Davitici: Davitici
Decii: Decii Decio
Decimius: Decimius
Dehas: Dehas
Deinsim: Deinsim
Deus: Deo
Deuteria: Deuteria Deoteriam Deoteriae Deoteria Deuteriam
Deotherius: Deotherius
Depopularis: Depopularis
Depraecante: Depraecante Depraecati
Depraecor: Depraecor
Desiderius: Desiderius
Dianae: Dianae Dianam
Didimia: Didimia Vindimia
Dilectissimis: Dilectissimis
Dinamium: Dinamium Dinamius Dinamio
Dinifius: Dinifi Dinifio Dinifius
Dionisius: Diocisis Dionisius Dionisi Dionisii
Diocliciani: Diocliciani Diocliciano
Diogenianum: Diogenianum
Discende: Discende
Discendente: Discendente
Discendentibus: Discendentibus
Disciola: Disciola
Dispargum: Dispargum
Dissistete: Dissistete
Divione: Divione
Divionensim: Divionensim Divionensem Divionensi Divioninsis Divionensis
Divitiam: Divitiam
Duno: Duno Dodo
Dodonem: Dodonem
Domegiselus: Domegiselus
Domicianus: Domicianus Domiciani
Domigysilo: Domigysilo Domighisilo
Domigysilus: Domigysilus
Dominus: Dominus Dominum Domini Domino
Domnolus: Domnolus Domnola Domnolae Domnolo
Dorononiam: Dorononiam
Dracolenus: Dracoleno Dracolenus Dracoleni Dracolenum
Droctegyselo: Droctegyselo
Droctigysilus: Droctigysilus
Droctulfus: Droctulfi Droctulfo Droctulfus Droctulfum
Dunense: Dunense Dunenses Dunensem
Dunensibus: Dunensibus
Eber: Eber
Eberegiselum: Eberegiselum
Ebron: Eberonem
Eberulfum: Eberulfo Eberulfum Eberulfi Eberulfus
Ebracharium: Ebracharium Ebracharius Ebrecharium
Ebredunensim: Ebredunensim Ebredunensem Ebredonense Ebredunensis
Ebregysilum: Ebregysilum Ebregysilus
Ecdicius: Ecdicius Ecdicium
Ecolesenensibus: Ecolesenensibus
Ecolesinam: Ecolesinam Ecolisinam Ecolisnae Ecolisnam
Ecolisinensim: Ecolisinensim Ecolesinensis Ecolesinensim
Edobecco: Edobecco
Edom: Edom
Egidium: Egidium Egidius Egidio Egidi
Egypti: Egypti
Eiecite: Eiecite
Elacrem: Elacrem
Elafius: Elafius Elafio
Elarius: Elarius Elarium
Eleazar: Eleazar
Eliachim: Eliachim
Eliuth: Eliuth
Emerium: Emerium
Emmanuhel: Emmanuhel
Enacim: Enacim
Ennodius: Ennodi Ennodius Ennodium
Enoch: Enoch Senoch
Enos: Enos
Eufronius: Eufronio Eufronii Eufronius Eufroni Eofronio Eufron Eofronius
Eonius: Eunio Eonius Eunius Eunium
Eonomius: Eonomius Eunomii Eunomius Eunomio
Eoricus: Eoricus Euricus Eurichus Eutices
Eorops: Eorops
Epagatum: Epagati Epagatum
Eparchius: Eparchio Eparchius
Epyfanius: Epyfanius Epifanius Epyfanio Epifanio
Epiphania: Epiphania
Epolon: Epolon
Eposium: Eposium
Equolisinensis: Equolisinensis
Eraclio: Eraclio
Ermeneghildo: Ermeneghildo
Erpone: Erpone Erponem
Esaias: Esaias Isaiae Isaiam
Esau: Esau Isac Isaac Isau
Esdrom: Esdrom # Esdron
Eseram: Eseram
Esichyus: Esichyus
Euantius: Euantius Euantium Euanti
Euarix: Euarix
Euchirium: Euchirium
Eufimiae: Eufimiae
Eufrasius: Eufrasius Eufrasio
Eugenius: Eugenius Eugenium Eugenio # Eugène
Eulalius: Eulalium Eulalio Eulalii Eulalius
Eusebius: Eusebius Eusebii Eusebium # Eusèbe
Eustochius: Eustochi Eustochius Eustochio
Eutropes: Eutropes
Euvarege: Euvarege
Euvodi: Euvodi
Eva: Evam Ewa Eva
Evina: Evina
Experear: Experear
Exsuperium: Exsuperium
Extetirunt: Extetirunt
Extetit: Extetit
Ezechihel: Ezechihel Ezechiel Ezechie
Factionarii: Factionarii
Faileuba: Faileuba Faileubam
Falech: Falech
Faramodus: Faramodus
Farronem: Farronem Farroni Faraone
Faraulfus: Faraulfus
Fausta: Faustam
Faustianus: Faustianus Faustianum
Ferreolus: Ferreolus Ferreoli Ferreolo
Felix: Filex
Festus: Festus
Filices: Filices Filici
Filius: Filius Fili Filia Filicem Filii Filio Filios Filium
Firminus: Firminus Firminum Firmino
Fistus: Fistus
Flavaris: Flavaris
Flavus: Flavus Flavum Flevi?
Flavianus: Flavianus Flaviano Flavianum
Florentianum: Florentianum
Floriacum: Floriacum
Francia: Francia Francorum Franciam
Francus: Francus Franciae Francos Francis Franci Francum Frantiae
Francilio: Francilio
Fredegundem: Fredegundem Fredegundae Fredegunde Fredegundis
Friardus: Friardo Friardus
Frigiretus: Frigiretus Frigiredi
Frigoriticis: Frigoriticis
Fronimius: Fronimi Fronimius
Frontonius: Frontonius Frontonium
Gabalitana: Gabalitana Gaballitani Gabalitanae Gabalitani Gabalitanorum
Gad: Gad
Gailenus: Gailenus Gailenum Gaileno
Gailesuinda: Gailesuinda
Gaiso: Gaiso Gaviso
Galate: Galate
Gallia: Gallia Galli Galliarum Galliae Gallias Galliis Gallo Gallum Gallus
Galienus: Galienus Gallienus Galienum # Galien
Galileis: Galileis Galleis
Gallicanis: Gallicanis
Gallitia: Galliciam Gallitia Gallitiam
Galliciensim: Galliciensim Galliciensis Galliciensibus
Gallomagnum: Gallomagnum Gallomagnus
Galsuintha: Gunsuintham Galsuintham Galsuintha
Garacharius: Garacharius
Gararicus: Gararico Gararicus
Garivaldum: Garivaldum
Garonnam: Garonnam
Gaudentius: Gaudentius
Gazitina: Gazitina
Gelesimeris: Gelesimeris
Genobaude: Genobaude
Genuveifa: Genuveifa
Germania: Germanias Germaniam Germania Germaniae
Germanus: Germanus Germani Germano
Gervasi: Gervasi
Ghotia: Ghotia
Goare: Goare Thare
Godegisilus: Godegisilus Godeghisilus Godigisilus Godeghisilum Godegiselum Godegiselus Godeghiselus Godigiselus
Godigiselo: Godigiselo Godigisili Godigisilo Godigyselo
Godomarum: Godomaro Godomarum Godomarus Godomari
Goisuintha: Goisuintha Goesintha
Gogo: Gogo Gogone
Goliam: Goliam Golian
Gothus: Gothi Gothos Gothis Gotis Gothus Gothum Gothorum
Gracina: Gracina
Gratianus: Gratianus Gratiani Gratianum
Gratianopolitanam: Gratianopolitanam
Gredonensis: Gredonensis
Gregorius: Gregorius Gregorii Gregori GREGORII
Grindionem: Grindionem
Gripo: Gripo Gripone Griponem Griponis Griponi
Gundegisilum: Gundegisilum Gundigisilum Gundigisilus Gundegysilus Gundigysilus Gundegysilum
Gundegyselo: Gundegyselo
Gundericus: Gundericus Gunderico
Gundevechus: Gundevechus
Gundobadus: Gundobadus Gundobadi Gundobadum Gundobado
Gundovaldum: Gundovaldo Gundovaldi Gundovaldum Gundovaldus
Gundulfus: Gundulfus Gundulfum Gundulfo
Guntharius: Guntharius Guntharium
Gunthecharius: Gunthecharius
Guntheucam: Guntheucam
Gunthramnus: Gunthramnus Gunthchramnus Gunthchramnum Gunthramnum Guntchramnum Guntchramnus Gunthramno Guntchramni Gunthchramno Guntchramno Gunthramni Gunthchramni Cunthchramno
Hebreae: Hebreae Hebraeos Hebraei Hebraeo Hebraeam
Helarius: Helarius Helarium Hylario Helarii Helari
Helenae: Helenae
Helius: Helius
Heliseum: Helisei Heliseum
Helosinsis: Helosinsis
Heraclius: Heraclius Heraclium Heraclio
Hermenefredum: Hermenefrede Hermenefredum Hermenefredo Hermenifredi Herminefredus Hermenefredus
Herminichildum: Herminichildum Herminigildus Herminichildus
Herodem: Herodem Herodis Herodes
Hesdras: Hesdras
Hieroboam: Hieroboam # Jérobam
Hieronimus: Hieronimi Hieronimus Hieronimusquae # Jérôme
Hierusalem: Hierusalem Hierusolimae Hierusolimis Hierusolima Hierusolimam Hierusolimorum Hierusolimitanus # Jérusalem
Hiezechihel: Hiezechihel
Hilarius: Hilarius Hilario Hilarii Hilari
Hillidio: Hillidio
Hirenaeum: Hirenaeum
Hireneus: Hireneus Hirineo
Hispanum: Hispanum Hispanis Hispaniis Hispanorum Hispaniorum Hispanias Hispaniam Hispaniae Hispani
Honoricus: Honoricus Honericus
Honori: Honori
Honorianis: Honorianis
Horosius: Horosi Horosius # Orose
Hortinsi: Hortinsi
Hospicius: Hospicius
Hyppolitus: Hyppolitus
Iacob: Iacobi Iacob Iacobus Iacobo
Iafeth: Iafeth Iareth
Iciodoro: Iciodoro
Idomeorum: Idomeorum # Iduméens
Iechonias: Iechonias
Ienubam: Ienubam # Genève
Iesus: Iesse Iesus Iesum Iesu
Ignatius: Ignatius
Ignarus: Ignarus
Illidius: Illidius Illidi
Imnacharium: Imnacharium Imnacharius
# Incongruae: Incongruae
# Indecastis: Indecastis
Indis: Indis Inde Indica
Ingytrudis: Ingytrudis Inghitrudis Ingitrudis
Ingoberga: Ingoberga Ingobergae Ingobergam
Ingomerem: Ingomerem
Ingunde: Ingunde Ingundis Ingundae Ingundem
Ingutrudem: Ingutrudem
Inicite: Inicite
Innocentio: Innocentio
Inquesivimus: Inquesivimus
Intendetis: Intendetis
Interia: Interia
Ioatha: Ioatha
Iob: Iob
Iobab: Iobab # Iob
Ioram: Ioram
Iocundiacensim: Iocundiacensim
Iohannis: Iohanne Iohannis
Iohel: Iohel
Ionas: Ionas
Iordanis: Iordanis Iordanne
Iosaphath: Iosaphath
Iosias: Iosias
Ioseph: Ioseph
Iosue: Iosue
Iovinianorum: Iovinianorum
Iovinus: Iovinus Iovium
Isachar: Isachar
Isiodorensis: Isiodorensis
Ismahelitis: Ismahelitis
Israhel: Israhel Israhelitarum Israheliticum Israheliticorum Israhelitae Israhelitici
Isychius: Isychius
Itala: Itala
Italia: Italia Italiam Italiae Italici
Iuda: Iudas Iuda Iudeam Iudei Iudaeum Iudae Iudaei Iudaeis Iudaeo Iudaeorum Iudaeos Iudaeus Iudaicae
Iudith: Iudith
Iuli-Consorannis: Iuli-Consorannis
Iuliensis: Iuliensis
Iulius: Iulius Iulii
Iustimniano: Iustimniano
Iustinus: Iustinus Iustini # imperator Iustiunus
Iustinum: Iustinum Iustina
Iustinianum: Iustinianum Iustinianus Iustiniano Iustiniani
Iustum: Iustum # Juste
Iuvencum: Iuvencum
Kyrie: Kyrie
Laba: Laba
Lacidaemoniis: Lacidaemoniis # Lacédémoniens
Laedorum: Laedorum # la Lydie
Lambrus: Lambrus
Lamech: Lamech
Lampadius: Lampadius
Langobardum: Langobardos Langobardum Langobardi Langobardus Langobardis
Langobardorum: Langobardorum
Lantechildis: Lantechildis
Lapurdo: Lapurdo
Laticina: Laticina
Latta: Latta
Laudiaco: Laudiaco
Laudiacum: Laudiacum Mauriacum
Laurentium: Laurenti Laurentium Laurentius
Lazarus: Lazarus Lazari
Legonus: Legonus Lyghnus
Limane: Limane Lemanem
Lemovecas: Lemovecas Limovicas Lemovicas
Lemovicinum: Lemovicinum Lemovicinae Lemovicinus Lemovicino Lemovicinam Limovicino Lemovicinis Limovicinum
Leobovera: Leobovera Leuboveram
Leocadium: Leocadium
Leonardus: Leonardus
Leonastis: Leonastis Leudastis
Leuva: Leuva Leuba Leubae
Leudaste: Leudaste Leubaste Leudastem Leunaste
Leuchadio: Leuchadio
Leudeghyselus: Leudeghyselus Leudeghyselum Leudeghiselus
Leudeghysili: Leudeghysili Leudeghisili
Leudovaldus: Leudovaldo Leudovaldus Leudovaldum Leodovaldus
Leuvane: Leuvane Leuvanis
Leuvichildus: Leuvichildus Leuvichildi Leuvichildum Leuvichildo Leuvichilde
Leuvieldus: Leuvieldus Leuvieldo Leuvieldi
Leuvigildus: Leuvigilde Leuvigildus Leuvigildi
Levi: Levi
Licaniacensis: Licaniacensis
Licerius: Licerius Litorius Liminius Licinius
Ligeris: Ligeris Ligerem
Lingonas: Lingonas
Lingonicam: Lingonicam Lingonicae Lingonicis Lingonici
Litorii: Litorii
Lixoensis: Lixoensis
Longinus: Longinus # Longin
Loth: Loth
Lovolautrum: Lovolautro Lovolautrum
Lucas: Lucas
Luciliacus: Luciliacus
Lugdunensis: Lugdunensis Lugdonensim Lugduninse Lugduninsis Lugdunensim Lugdunense Lugdunensi
Lugdunensibus: Lugdunensibus
Lugdunum: Lugduno Lugdunum Lugdunos Lugduni
Lupentius: Lupentius Lupenti
Lupus: Lupus Lupum Lupi Lupo
Lytigius: Lytigius
# MCCCCIIII: MCCCCIIII
# MDXXXVIII: MDXXXVIII
Maccone: Maccone Macconem Macconi
Macedoniis: Macedoniis
Machao: Machao Macco
Macliavum: Macliavi Macliavum Macliavus
Magdalum: Magdalum
Magnachari: Magnacharii Magnachari
Magnarii: Magnarii
Magnatrudis: Magnatrudis Marcatrudis
Magnericus: Magnericus Magnerici Magnerico
Magnovaldus: Magnovaldus Ragnovaldi Ragnovaldus Magnovaldi Ragnovaldo
Magnulfum: Magnulfi Magnulfo Magnulfum
Malalehel: Malalehel
Mallulfus: Mallulfus
Mamerto: Mamerto
Manatensis: Manatensis
Manefestissime: Manefestissime
Manicheum: Manicheum
Mannases: Mannases
Mantolomaus: Mantolomaus
Maratis: Maratis
Maracharius: Maracharius
Marcatrudem: Marcatrudem
Marcus: Marcus Marcum Marco Marcio
Marcellus: Marcelli Marcellini
Marcialis: Marcialis
Marcionitana: Marcionitana # imperator
Marcomere: Marcomere Marcomere
Marcovefa: Marcovefa Marcoveifa Marcoveifam
Mariam: Mariam
Marilegio: Marilegio
Marileifum: Marileifi Marileifum Marileifo
Mariligensis: Mariligensis
Maroialensi: Maroialensi Maroialensim
Maroveus: Maroveus Maroveo Maroveum
Mars: Mars
Martha: Martha Mathan
Martianus: Martianus Martinus Martino Martine
Massilia: Masiliam Massiliae Massilia Massiliam
Massiliensim: Massiliensim Massiliensis Massiliensem Massiliense Masiliensi Masiliensim
Matiscensim: Matiscensim Matescense Matascensem
Matiscone: Matiscone
Mattusalam: Mattusalam
Mauricius: Mauricius Mauricium
Mauritio: Mauritio Maurilione Maurilio
Mauriopes: Mauriopes
Mauritaniam: Mauritaniam
Maxentius: Maxenti Maxentius
Maximus: Maximus Maximi Maximum Maxime
Maximinus: Maximinus # Maximin
Mecledonensem: Mecledonensem Megledonense
Medardum: Medardi Medardum Medardus
Mediconno: Mediconno
Mediolanensis: Mediolanensis Mediolanensem Mediolanensim
Mediolaninsibus: Mediolaninsibus
Meduanae: Meduanae
Melanea: Melanea Melantio Melanio Melania
Melantium: Melantium Melantius Venantius
Meldensem: Meldensem Melitensim Meldensi Meldensim Sellensim
Meledus: Meledus
Meminiat: Meminiat
Memmatinsis: Memmatinsis
Merofledem: Merofledem Merofledis
Meroliacensae: Meroliacensae Meroliacensis
Merovechum: Merovechum Merovechus Merovecho Merovechi
Mettensis: Mettensis Mettensim Metinsis Metensem Mettinsem Metensim Metinsim
Michahel: Michahel
Mimate: Mimate # Mende
# Minibatur: Minibatur
Mironem: Mironem Mironis
Mittense: Mittense
Moabitibus: Moabitibus
Mogontiacum: Mogontiacum
Momotiacensis: Momotiacensis
Montalomaginsim: Montalomaginsim
Moysaicas: Moysaicas Moysaicae
Moyse: Moyse Moysi Moysen Moyses
Mummolus: Mummolo Mummolini Mummolus Mummoli Mummolum
Mundericus: Mundericus Munderico Munderici Mundericum
Musella: Musella Musellam
Mustias: Mustias
Naason: Naason
Nabuchodonosor: Nabuchodonosor
Namatius: Namati Namatius Namatium
Namnetas: Namnetas
Namneticum: Namnetico Namneticam Namneticis Namneticum Namneticae Namnitico Namneticos
Namneticorum: Namneticorum
Nanninus: Nanneni Nanninus Nannenus Nanneno
Nanthinus: Nanthinus Nanthino
Narbonam: Narbonam Narbonae Narbonensem Narbonensim # Narbonne
Narsiti: Narsiti Narsitem Narsite Narsitis Narsis Narsitae
Nathan: Nathan
Nebroth: Nebroth
Necetius: Necetius Nicetius Nicetio Nicetii Niceti
Nectarius: Nectarius Nectarii Nectarium
Negutium: Negutium
Nemausensis: Nemausensis
Nemausus: Nemausus Nemausum
Nemptudoro: Nemptudoro
Nepotianus: Nepotianus
Neptalem: Neptalem
Nerone: Nerone Neronem
Nevernensem: Nevernensem
Neverno: Neverno
Nicaene: Nicaene # Nicée
Nicasium: Nicasium Nicasio
Niceam: Niceam
Nicenum: Nicenum Nicensim Nicensis # Nice?
Nilus: Nilus Niliculae# Nil?
Nineven: Nineven # Ninive
Ninus: Ninus Nino Ninum # Noé
Ninivitarum: Ninivitarum Ninnivitarum
Nisebenus: Nisebenus Nisebeno
Nivisium: Nivisium # Neuss
Nocito: Nocito
Noe: Noe # Noé
Nonnichius: Nonnichius Nonnichium
Novatianus: Novatianus
Novigentum: Novigentum
Noviliacus: Noviliacus
Novimpopulanae: Novimpopulanae
Nunnichio: Nunnichio
Nuperrimo: Nuperrimo
Obeth: Obeth
Oblivione: Oblivione
Obsedente: Obsedente
Obtestabat: Obtestabat
Occila: Occila
Octavianus: Octavianus
Octobrio: Octobrio
Ollone: Ollone
Olofernis: Olofernis
Ommatius: Ommatius
Onestrudem: Onestrudem
Operiebamur: Operiebamur
# Oportit: Oportit
# Oppraessus: Oppraessus
Orbaniaco: Orbaniaco
Orbico: Orbico
Orestes: Orestes
Orhosius: Orhosius
Oriente: Oriente
Oscarum: Oscarum Oscaram
Osser: Osser
Otto: Otto
Oxion: Oxion
Ozia: Ozia
Palladius: Palladius Palladi
Pannoniis: Pannoniis # Pannonie
Papianilla: Papianilla
Pappolum: Pappolo Pappolum Pappole
Parius: Parius Parisios Pariseus Parisius
Parisiacus: Parisiaci Parisiacae Parisiaco Parisiacus Parisiaca Parisiacam Parisiacis
Parisiorum: Parisiorum
Partheni: Partheni
Pascentius: Pascentius
Pathir: Pathir Pathiren
Pathmos: Pathmos
Patroclus: Patroclus
Paulelli: Paulelli
Paulinus: Paulinus
Paulo: Paulo
Pectava: Pectava Pectavina Pectavum Pictavus Pectavis Pectavo Pictavi Pectavam Pectavi Pectavos Pectavus Pectavae Pictava Pectavorum # Poitiers
Pectavensis: Pectavensis Pectavense Pectavinse Pictavensis Pictavensi Pectavensi Pectavinsim Pectavensem Pictavinsis Pictavensim Pectavensibus # de Poitiers
Pegasium: Pegasium
Pelagiana: Pelagiana Pelagius Pelagiam
Peonius: Peonius Peonio
Perdedemus: Perdedemus
Persida: Persi Persida Persas
Persi-Armeni: Persi-Armeni
Petreum: Petreum Petros Petri Petrus
Petrocoricum: Petrocoricae Petrocoricum Petrogoricae Petrogoricum Petrocoricis Petrocoris
Phario: Phario Pharao Pharaone
Phares: Phares
Phiahiroth: Phiahiroth
Photinus: Photinus Photino
Pientius: Pientius Pientio
Pilati: Pilati
Pirineis: Pirineis
Placentiam: Placentiam
Placidina: Placidina
Policarpus: Policarpi Policarpus Policarpo
Polioctus: Polioctus
Ponticonem: Ponticonem
Porcarium: Porcarium
Potasne: Potasne
Potato: Potato
Praeciperam: Praeciperam
Prilidan: Prilidan
Privatus: Privatus Privato
Proina: Proina
Prosequenti: Prosequenti
Prosternamus: Prosternamus
Protasi: Protasi
Pylatus: Pylatus
Pyrenius: Pyrenius
Quartanariis: Quartanariis
Quinciani: Quinciani
Quintianum: Quintianum Quintino Quintinus Quintianus
Quirinus: Quirinus Quiriacus
Quirici: Quirici
Rachel: Rachel Raguel
Radegundis: Radegundis Radigundi Radegundem Radegundae Radegunde
Ragnacharius: Ragnachari Ragnechario Ragnacharius
Ragnimodus: Ragnemodo Ragnimodi Ragnimodus Ragnemodus Ragnimodo
Randanensim: Randanensim
Ratharius: Ratharium Ratharius
Rauchingum: Rauchingi Rauchingum Rauchingo Rauchingus
Rebecca: Rebecca
Redemptur: Redemptur # Rédempteur
Redonensis: Redonensis
Rhedonicus: Redonicum Rhedonicus Rhedonicis Redonicam
Remensem: Remensem Remense Remensim Regensim
Remegius: Remegius Remigius Remegii
Renatus: Renatus Renati
Reovalis: Reovalis
Resedentibus: Resedentibus
Respendial: Respendial
Retenuisti: Retenuisti
Rhenus: Rheu Rhenus Rheno Rhenum
Rhodanus: Rhodani Rodano Rhodanus Rhodanum Rodanus
Rhodanitica: Rhodanitica
Rhodanitides: Rhodanitides
Rhodomaginsis: Rhodomaginsem Rodomaginsem Rhotomaginsem Rhodomagensie Rhodomaginsis
Rhodomago: Rhodomago Rotomago Rodomago
Richaridus: Richaredi Richaridus Richaredum Richaredus Richaredo Richaridi
Richario: Richario
Richimeris: Richimeris
Riculfus: Riculfum Riculfus Riculfo
Rignomeris: Rignomeris
Rigoialinsim: Rigoialinsim Rodoialensim Rotoialinsim
Rigundem: Rigundem Rigundae Rigundis
Rigunthae: Rigunthae Rigunthis Rigunthe
Rimensium: Rimensium
Roboam: Roboam Roboae # Roboam
Roccolenus: Roccolenus
Roma: Roma Romam Romae
Romacharius: Romacharius
Romaniacum: Romaniacum
Romanum: Romanorum Romanam Romanae # Romains
Romulfus: Romulfus Romulfum
Rosontinse: Rosontinse
Rotomagensis: Rotomagensis Rothomagensim Rothomagensis
Rothomaginse: Rothomaginse
Rubrum mare: Rubrum mare # Mer Rouge
Rutinus: Rutini Rutino Rutinus Rutena Ruteni Rubin Rutina Rutinae Rutinam Rutenae
Rutenensis: Rutenensis
Rutenorum: Rutenorum
Sabariam: Sabariam
Sabaudus: Sabaudus
Sabellius: Sabellius
Sadduceae: Sadduceae
Sadoch: Sadoch Saruch
Saffarium: Saffarium Saffaracum
Saffario: Saffario
Saffirae: Saffirae
Salamonis: Salamonis Salamonem Salomonem Salamones Salamon Salomonis Salamone Salomon
Salamoneacae: Salamoneacae
Salathiel: Salathiel
Sale: Sale # Salé
Saxonis: Saxonis Saxone Saxonibus
Salma: Salma
Salonium: Salonium Salonius Saloni
Salunio: Salunio
Salustius: Salustii Salustius Salustium
Samson: Samson Samsonis
Samuhel: Samuhel Samuelem
Satanas: Satanas # Satan
Santonas: Santonas Sanctonas
Santonicum: Sanctonici Santonicae Santonico Santonicum Sanctonicae Sanctonicam Sanctonicum Sanctonicis Sanctonicorum
Saturnus: Saturnus Saturninum
Saul: Saul
Sauriciacum: Sauriciacum
Saxenum: Saxenum Saxonum
Scaldem: Scaldem
Scalonum: Scalonum
Scaptharius: Scaptharius Scaptharium
Scarioticas: Scarioticas
Scriptura: Scriptura # Les Ecritures
Scyciae: Scyciae
Secundini: Secundini
Sidulium: Sidulium Sedulium
Sigila: Sigila
Sigusium: Sigusium
Sem: Sem
Semoes: Semoes
Senachar: Senachar
Septimania: Septimania Septimaneam Septimaniam Septemaniae
Septembre: Septembre
Septimina: Septimina Septiminae
Sequanam: Sequanam
Sergi: Sergi
Servius: Servius
Seth: Seth
Severus: Severus # Suplice Sévère
Sexonas: Sexonas Sessionas Sessonas
Sessionica: Sessionica Sessionico Sessionici Sessionicae
Siacrius: Siacrius Syagrius Sigarius Siagrius Siacrium Syacrius
Siagri: Siagri Siagrio
Sicharius: Sichario Sicharius Sichari Sicharium
Sicionius: Sicionius Siggonis Sicionis
Sidonium: Sidonio Simonis Sidonium Sidonii Sidoni Simoni Sidonius
Sigamber: Sigamber
Siggo: Siggo
Syghiberthi: Syghiberthi Sigyberthi Sygibertho Sigiberthi Sigybertho Syghiberti Sygiberthi Sigiberti Sigibertho
Sygiberthus: Sygiberthus Sigiberthus Sigyberthum Syghiberthus Sygibertus Sygiberthum Sigibertum Sigyberthus
Sigimundus: Sigimundo Sigymundo Sigimundus Sigimundum Sigymundum
Sigiricum: Sigiricum
Sigivaldus: Sigivaldus Sigivaldo Sigivaldum Sigyvaldus Sigivaldi
Sigulfus: Sigulfus Sigulfum Sigulfo
Silvanectensi: Silvanectensi Silvanectensim Silvanectensis
Silvanectinse: Silvanectinse Silvanectis
Silvestrum: Silvestrum
Silvius: Silvius Sollius
Simon: Symeoni Symon Simonem Simion Simeone Simon Semeon
Simphoriani: Simphoriani Symphoriani
Sinonicae: Sinonicae
Siriae: Siriae
Sirivuldum: Sirivuldi Sirivuldo Sirivuldum
Sirus: Sirus
Sisciensis: Sisciensis
Sisinnius: Sisinnio Sisinnius
Socratium: Socratium
Sodomae: Sodomae Sodomis
Solonacensi: Solonacensi
Spanias: Spanias Spaniis Spanis Spaniam
Stablonem: Stablonem
Stampensim: Stampensim
Stampinse: Stampinse
Stefanum: Stefanum Stefani Stefanus
Stephani: Stephani
Strateburgum: Strateburgum
Stremoneus: Stremoneus Stremonius Stremonium
Sueborum: Sueborum Suavorum
Suebi: Suebi
Sulpitius: Sulpitius
Sulpici: Sulpici
Sumenam: Sumenam
Sunnigysilus: Sunnigysilus Sunnegisilus Sunnegysilum
Sunniulfus: Sunniulfo Sunniulfus
Sunnone: Sunnone Sunnonem
Supplecat: Supplecat
Susanna: Susanna
Sygona: Sygona
Synonicum: Synonicum
Syrorum: Syrorum
Syrus: Syrus
Turonensis: TURONENSIS
Tacem: Tacem
Taedit: Taedit Tradedit
Tarabannensibus: Tarabannensibus
Tattonis: Tattonis
Tauredune: Tauredune Taureduno
Tausiriaco: Tausiriaco
Terentiolus: Terentiolus
Ternoderinsim: Ternoderinsim
Tetradius: Tetradiam Tetradius Tetradiae Tetradia
Teutarius: Teutarius Theutharius Theutharium
Thebei: Thebei
Theuda: Theuda Thecla
Theifalorum: Theifalorum
Theifalus: Theifalus
Theodadum: Theodadum
Theodoberthum: Theodoberthum Theudoberthum Theudoberto Theudoberthus Theodoberto Theodoberthus Theodeberthum Theodobertum Theodoberthi Theodobertho Theudobertho Theudobertus Theudoberthi Theudobertum
Theodosius: Theodosius Theodosio
Theodovaldum: Theodovaldum Theodobaldum Theodovaldus Theodovaldi Theudovaldo
Theodogildis: Theodogildis
Theudori: Theudori Theodor Theudor Theudosi Theudoro
Theodoricus: Theodoricus Theodoricum Theudorico Theudoricus Theudoricum Theudericum Theuderici Theodorici Theudorici Theudericus
Theodulfum: Theodulfum
Thesaurizamus: Thesaurizamus
Theudegisilum: Theudegisilum
Theudoaldus: Theudoaldus
Theudogildem: Theudogildem
Theudomerem: Theudomerem
Theudulfi: Theudulfi
Theudulfus: Theudulfus Trudulfus
Tholosa: Tolosae Tholosano Tholosam Tholosa Tholosae Tholosana
Tholosanorum: Tholosanorum
Thoringus: Thoringis Thoringus Thoringi Thoringiam Thoringia
Thoringorum: Thoringorum
Thorismodus: Thorismodus Thorismodo
Thornacinsis: Thornacinsis Tornacensis Tornacensi
Thornaco: Thornaco
Toronica: Toronicae Toronicis Toronicos Turonicis Toronicam Turonico Toronica Thoronici Turonicum Turonici Thoronica Toronicum Toronici Toronico Toronicus Turonicae Toronice Turonica Turonicus Thoronicae Turonicam
Thoronorum: Thoronorum Turonorum Toronorum
Thracias: Thracias
Turonus: Turonus Thoronus Toronus Toronum
Tiberius: Tiberium Tiberius Tiberii
Ticinensis: Ticinensis
Ticinum: Ticinum
Tolidum: Tolidum Toletum
Tolosanis: Tolosanis
Tonicam: Tonicam
Tornacum: Tornacum
Tornomagensi: Tornomagensi
Traguilanem: Traguilanem
Traianus: Traiano Traianus Traiani
Transobadus: Transobadus
Trasamundus: Trasamundo Trasamundus
Trecas: Trecas
Tropas: Tropas
Treiectinsem: Treiectinsem # Maastricht
Treverica: Treverici Treverecam Trevericae Treverica Trivericam
Treverus: Treverus Treveris Treverorum
Tricassinorum: Tricassinorum Tricassinum
Trinitatem: Trinitatem Trinitate
Trophimus: Trophimus
Tulbiacensis: Tulbiacensis Tulbiacensim
Tune: Tune
Tungrorum: Tungrorum
Tungrus: Tungrus
Ucecensis: Ucecensis
Ucetica: Ucetica
Ugernum: Ugernum
Uldam: Uldam
Ultrogotho: Ultrogotho
Urban: Urban Urbano
Urbecus: Urbecus Urbicus
Urbiam: Urbiam
Urbiensim: Urbiensim
Ursicinus: Ursicinus
Ursio: Ursio Ursionis Ursione
# Utire: Utire
# VDCCXCII: VDCCXCII
Vabrense: Vabrense Vabrensim
Vafres: Vafres
Valdenus: Valdenus
Valentis: Valentis # Valens
Valentiniani: Valentiniani # Valentinien
Valentiniana: Valentiniana
Valerianus: Valerianus
Vappinsis: Vappinsis
Warocus: Waroci Warocus Varocum Warocum Warochus Waroco Warocho Varochus
Valentinianum: Valentinianum
Vasatinsis: Vasatinsis Vasatensem Vasatensis
Vasconiam: Vasconiam
Vasso: Vasso
Vectium: Vectium
Vellavae: Vellavae
# Vellim: Vellim
Veneticae: Veneticae Veneticam
# Venirunt: Venirunt
Venitus: Venitus # Vannes
Winnocus: Winnocus Vennocus
Veranus: Veranus Veranum
Vercellensim: Vercellensim
Veredunensem: Veredunensem Veridunense
Vincenti: Vincenti Vincentio
Vinciensis: Vinciensis
Viredunensim: Viredunensim Virdunensis Veredunensis Viridunensim Viredunensis
# Verumne: Verumne
Vicinoniae: Vicinoniae Vicinoniam
# Vicinsimo: Vicinsimo
Victorinus: Victorinus # Victorien
Victorius: Victorius Victorium Victurius Victuris # Victor
Victuriacense: Victuriacense
Victuriacum: Victuriacum Victuriaci Victuriaco
Vidimacle: Vidimacle
Viennae: Viennae Vingennam Vigennam Viennam Viennense Viennensis
Villavum: Villavo Villavis Villavum
Vindimialem: Vindimialem Vindimialis
Vindocino: Vindocino
Vinitico: Vinitico
Vinthrione: Vinthrione
Vircellis: Vircellis
Virgilius: Virgilii Virgilius
Viridunum: Viridunum
Visigardem: Visigardem Wisigardem
Visorontiam: Visorontiam
Vispasiano: Vispasiano
Vivariensim: Vivariensim
Vogladense: Vogladense Vogladinse
Volusianus: Volusianus Volosiani
Vosagum: Vosagum Vosagensim
Vuldotradam: Vuldotradam Vuldetradam
Vulfelaici: Vulfelaici Vulfilaico
Vulthrogotham: Vulthrogotham
Wa: Wa
Wandalini: Wandalini Wandali Wandalis
Wandalorum: Wandalorum
Wandelenus: Wandelenus
Warmarium: Warmarium
Wascones: Wascones Wasconibus
Werpinum: Werpino Werpinum
Wiliacharius: Willachario Wiliachario Wiliacharius Wiliacharium Wiliacharii
Wiliulfum: Wiliulfum Wiliulfi
Winnoco: Winnoco
Wintrio: Wintrio
Wistrimundi: Wistrimundi
Xystus: Xystus
Zabanis: Zabanis Zabanem
Zara: Zara Zaban Zaba
Zabulon: Zabulon
Zelo: Zelo
Zoroastren: Zoroastren
Zorobabil: Zorobabil
