Abia: Abia # Abias
Abrincatis: Abrincatis # Avranches
Acaunos: Acaunos Acaunensim Acaunenses Acaunensium # Aucane d'Agaune, de Saint-Maurice
Aecolinensis: Aecolinensis
Aeclesiae: Aeclesiae # Eglise
Aegyptus: Aegipto Aegyptu Aegyptum Aegyptiorum Aegyptiarum Aegypti Aegyptiis Aegyptio Aegyptiorum Aegyptios Aegyptius Aegypto Aegyptum # Egypte
Aetalia: Aetaliae # Italie (vel Italia)
Africa: Africa Africae Africam Africanum # Afrique
Agatha: Agathaes Agathensi Agathensis # Agde
Agenninsis: Agenninsis Agennensibus # Agen
Aginnum: Aginnum # Agen
Agripina: Agripinam Agrepinam # Cologne
Agrippinensis: Agrippinensi Agripinensim # Cologne
Agustidunensi: Agustidunensi Agustidunensim Agustidunensis # d'Autun
Agustidunum: Agustidunum # Autun
Alamanni: Alamannus Alamanni Alamannos Alamannis Alamannorum
Alani: Alanos Alanis Alanorum # les Alains
Albiga: Albige Albigae Albigensis Albiginsem Albigensim Albigensem Albigense Albiginsibus # Albi
Alingaviensis: Alingaviensi # Langeais
Ambaciensis: Ambaciensi Ambaciensim # Amboise
Andecavus: Andecavi Andecavam Andecavus Andecavo Andecavos Andecavum Andecavis Andecavae # Anjou
Andegavensis: Andegavensis Andecavensis # Angers
Andigavus: Andegavis Andigavam Andigavus # d'Angers
Anicius: Anicium # Puy-en-Velay
Anthiocia: Anthiocenae Anthiocia Anthiociae # Antioche
Anthiocensis: Anthiocensis Anthyocinsis # d'Antioche
Anthiocinus: Anthiocinus Anthiochino # d'Antioche
Apamiae: Apamiae # Apamée
Aquae: Aquae # Aix, Dax ?
Aquensis: Aquensim Aquinsi Aquinsibus# Aix
Aquileia: Aquileia Aquileiam # Aquilée
Arareca: Ararem Arareca # Saône
Ardoennensis: Ardoennensis # Ardennes
Arelate: Arelate # Arles
Arelatense: Arelatense Arelatensim Arilatensim Arelatensis Arelatinsim Arelatinsi Arelatensibus
Argentoratinsim: Argentoratinsim Strateburgum# Strasbourg
Argivus: Argivus Argeus # Argiens
Arietis: Arietis # château de Cabaret (Caput Arietis)
Arisitensis: Arisitensim # Alais? Alès?
Arminia: Arminia Arminiorum # Arménie
Arvernus: Arvernam Arvernus Arverni Arverna Arverno Arverne Arvernum Arvernis Arvernae Arvernorum # Arvernes
Asia: Asia # Asie
Assirii: Assirios # Assyriens
Athiniensis: Athiniensibus # des Athéniens
Attica: Attica Attico # Attique
Audisiodorensim: Audisiodorensim Audisiodorensis # Auxerre
Aurilianus: Aurilianis Aurilianus Auriliano # Orléans
Aurilianensis: Aurilianensim Aurilianensem Aurilianensis Aurilianinsim Aurilianensium Aurilianense Aurilianensibus
Auscensis: Auscensis Ausciensim # Auch
Avennica: Avennico Avennica Avennicae Avennici Avennecam Avennicam Avennicorum # Avennio
Avenniensis: Avenniensis
Avinionem: Avinionem Avenione Avennionem Avennione # Avignon

Babel: Babel
Babillonia: Babillonia Babiloniam Babilonia # Babylone
Baiocassini: Baiocassini Baiocassinos Baiocassino # Baïocasse, Bayeux
Balatedinis: Balatedine # Ballan, Balesmes?
Belsephon: Belsephon
Belsonancus: Belsonancum Belsonanco
Benarna: Benarnae Benarno # Béarn
Beretrudis: Beretrudis # Barrou?
Berraus: Berrao Berravensis # Barrou
Bethleem: Bethleem
Bilitionem: Bilitionem # Bellinzone
Biterris: Biterris Biterrensim # Bézier
Beturiga: Betoricum Bitoricum Biturigi Beturigum Biturigo Bituricas Bitoricas Biturigae Bituricam Biturigis Bitorigus Bitorigo Biturigum Biturigas Byturigi Bituriga Biturigus Bituricae Beturica Bitorex # Bourges
Blesensis: Blesensis Blesensibus # de Blois
Bononia: Bononiae # Bologne
Brinnacus: Brannacum Brinnacum Brinnaco Brinnacinsis # Braine/Berny
Bricca: Bricca # Brèches
Bricteri: Bricteros # Bructères
Briotreidis: Briotreide # Bléré
Brinctanorum: Brinctanorum Brittanorum # Bretons
Brictionem: Brictionem # Bretagne
Brittanus: Brittaniam Brittanis Brittaniis Brittanus Brittanos Brittanias Brittaniae Brittani Brittania
Britto: Britto Brittone
Briva: Brivam  # Brive
Briva-Curretia: Briva-Curretia # Brive la Gaillarde
Brivate: Brivate Brivatensim Brivatinsem # Brioude
Brixis: Brixis # Reignac-sur-Indre
Buconia: Buconiam # Buchau/Buconie (forêt)
Bulgiatensim: Bulgiatensim # Bongheat/Bolgiac
Burdegala: Burdegala Burdigale # Bordeaux
Burgundia: Burgundias Burgundiam Burgundiae Burgundia Burgundiones Burgondiones Burgundione Burgundionis Burgundionum Burgundionibus Burdigalinsis Burdegalinsem Burdigalensis Burdegalensi Burdigalensim Burdigalinsi Burdegalensem Burdegalinsis Burdigalense Burdegalensim Burdegalensis Burdigalinsim Burdegalensibus # Bugondie


Cabillonum: Cabillonno Cavellonum Cabillonum Cavillonum Cavillonno Cabillonnensis Cavillonensim
Cadurcinsis: Cadurcinsis Cadurcensis Cadurcinis # Cahors
Cadurcus: Cadurcus Cadurcorum Cadurcum Cadurcis Cadurcinum Caturcinae Cadurcinae # Quercy?
Caesaraugusta: Caesaragustanam Caesaraugustae # Saragosse
Caino: Caione Caino Cainonensem Cainoninse # Chinon
Cala: Calam Calensi Calensim # Chelles
Calatonnus: Calatonno # Catalonique
Calliciensis: Calliciense Calliciensibus # = Galliciensis
Calmes: Calmes
Calvariae: Calvariae # Calvaire
Camaracus: Camaracum Camaracense # Cambrai
Campania: Campania Campaniae Campanensis # Cologne? la Champagne?
Cantobennicus: Cantobennici Cantabennensi # Chantoin
Capitulium: Capitulium Capitulio # Capitole (de Toulouse)
Capraria: Caprariam # Cabrières
Carbonaria: Carbonariam # Charbonnière
Carcasona: Carcasonam Carcasonensibus # Carcassone
Cares: Cares # le Cher
Carnotena: Carnotenum Carnotenis Carnotensim Carnotenorum Carnotinae Carnotino Carnotenae Carnotena # Chartres
Carpitania: Carpitaniam Carpitania # Carpétanie
Cartago: Cartaginem Cartaginensis Chartaginensis Carthaginensibus # Carthage
Catalaunensis: Catalaunensis # Châlons (Catalaunensis: catalaunique ?)
Catthi: Catthis # Chattes
Cavillonensim: Cavelonensis Cavellionensim # Cavaillon
Cenomannica: Cenomannorum Cenomanicos Cenomannorum Cinomannorum Caenomannicae Caenomannici Caenomannensis # le Mans
Cerate: Cerate # Céré (la Ronde)
Chanaan: Chanaan # Canaan
Chrononensim: Chrononensim # Cournon
Chunus: Chunus Chunis Chuni Chunos Chunorum # Huns
Cinomannis: Cinnomannicum Cinomanensim Cinomannis Cinomannica Cinomannico Cinomannicis # Maine
Cisomagensis: Cisomagensi # Ciran
Clavat: Clavati # Lugduni Clavati -> Laon
Clysma: Clysma # Clysma
Colomna: Colomnam Colomna
Colonia: Colonia Coloniae # Cologne (Agrippinensi)
Condatensis: Condatinsem Condatensi Condatensim Condatensis # Candes
Confluentis: Confluentis # (castrum) Koblentz
Conpendium: Conpendio # Compiègne
Iuli-Consorannis # Couserans
Constantina: Constantinam Constantinae # Coutances?
Constantinopolis: Constantinopuli Constantinopoli Constantinopolim Constantinopolitanam
Convenae: Convenas Convenicae Convenassic # Comminges?
Corinthii: Corinthiis # Corinthe
Cornutius: Cornutium # Corps-Nuds

Deinsim: Deinsim # Die
Dionisius: Diocisis Dionisius Dionisi Dionisii # Saint-Denis
Dispargum: Dispargum # Duisburg?
Divio: Divione Divionensim Divionensem Divionensi Divioninsis Divionensis # Dijon
Divitia: Divitiam # Deutz
Dolensis: Dolensim # Déols
Dolus: Dolus # Dolus
Dorononia: Dorononiam # Dordogne
Dunense: Dunense Dunenses Dunensem Dunensibus # (castrum) Chateaudun
Dunum: Duno

Eber: Eber # Eber
Ebredunensis: Ebredunensim Ebredunensem Ebredonense Ebredunensis # Embrun
Ecolesina: Ecolesinam Ecolisinam Ecolisnae Ecolisnam # Angoulême
Ecolisinensis: Ecolisinensim Ecolesinensis Ecolesinensim Ecolesenensibus Equolisinensis # d'Angoulême
Egypti: Egypti # Egypte
Elacris: Elacrem
Elarius: Elarius Elarium # Alliers
Esera: Eseram # Isère
Evina: Evina # Esvres

Floriacum: Floriacum # Fleury

Gabalitana: Gabalitana Gaballitani Gabalitanae Gabalitani Gabalitanorum # Gévaudan
Galileis: Galileis Galleis # Galilée
Gallia: Gallia Galliarum Galliae Gallias Galliis
Gallitia: Galliciam Gallitia Gallitiam # Galice
Gallica: Gallicanis # Gaulois
Galliciensis: Galliciensim Galliciensis Galliciensibus
Gallus: Gallo Gallum Gallus Galli
Garonna: Garonnam # Garonne
Germania: Germanias Germaniam Germania Germaniae
Ghotia: Ghotia # Gothie
Gothi: Gothi Gothos Gothis Gotis Gothus Gothum Gothorum # Goths
Graeci: Graeci # Grecs
Gratianopolitana: Gratianopolitanam # Grenoble
Gredonensis: Gredonensis # Grèzes

Hebraei: Hebreae Hebraeos Hebraei Hebraeo Hebraeam # Hébreux
Helosinsis: Helosinsis # Eauze
Hierusalem: Hierusalem Hierusolimae Hierusolimis Hierusolima Hierusolimam Hierusolimorum Hierusolimitanus # Jérusalem
Hispani: Hispanum Hispanis Hispaniis Hispanorum Hispaniorum Hispanias Hispaniam Hispaniae Hispani # Espagne

Iciodorus: Iciodoro Isiodorensis # Yzeures
Iocundiacensis: Iocundiacensim
Idomei: Idomeorum # Iduméens
Ienuba: Ienubam # Genève
Ismahelitae: Ismahelitis # Ismaélites
Israhel: Israhel Israhelitarum Israheliticum Israheliticorum Israhelitae Israhelitici
Itala: Itala
Italia: Italia Italiam Italiae Italici # Italie
Iudaei: Iudaei Iudaeis Iudaeum Iudaeo Iudaeorum Iudaeos Iudaeus Iudaicae
Iuliensis: Iuliensis

Lacidaemonii: Lacidaemoniis # Lacédémoniens
Laedi: Laedorum # la Lydie
Lambrus: Lambrus # Lambres
Langobardi: Langobardos Langobardum Langobardi Langobardus Langobardis Langobardorum
Latinus: Latinus Latini Latinorum
Latium: Latium # Latium
Latta: Latta # Latta
Laudiacus: Laudiacum Laudiaco # Montlouis sur Loire
Lemanis: Lemanem # Limagne
Lemovicas: Lemovicinum Lemovicinae Lemovicinus Lemovicino Lemovicinam Limovicino Lemovicinis Limovicinum Lemovecas Limovicas Lemovicas Limane # Limoges
Licaniacensis: Licaniacensis
Liger: Ligeris Ligerem Leger Legerem Legeris Legere
Lingonas: Lingonas Lingonicam Lingonicae Lingonicis Lingonici # Langres
Lixoensis: Lixoensis # Lisieux
Lovolautrum: Lovolautro Lovolautrum # Volorre
Lugdunensis: Lugdunensis Lugdonensim Lugduninse Lugduninsis Lugdunensim Lugdunense Lugdunensi Lugdunensibus
Lugdunum: Lugduno Lugdunum Lugdunos Lugduni
Lucas: Lucas # Loches
Luciliacus: Luciliacus # Luzillé


Machao: Machao # ?
Macedonii: Macedoniis # Macédoniens
Manatensis: Manatensis # Menat
Mantolomaus: Mantolomaus Montalomaginsim # Manthelan
Marilegius: Marilegio Mariligensis # Marlheim
Maroialensis: Maroialensi Maroialensim # Mareuil-sur-Cher
Massilia: Masiliam Massiliae Massilia Massiliam Massiliensim Massiliensis Massiliensem Massiliense Masiliensi Masiliensim # Marseille
Matisco: Matiscone Matiscensim Matescense Matascensem # Mâcon
Matrona: Matrona Matronam Matronae # Marne
Mauriacus: Mauriacum
Mauriopes: Mauriopes # Mauriopes
Mauritania: Mauritaniam # Mauritanie
Mecledonensis: Mecledonensem Megledonense # Melun
Mediconnus: Mediconno # Mosnes/Mougon
Mediolaninsis: Mediolaninsibus Mediolanensis Mediolanensem Mediolanensim # Milan/Chateaumeillant
Meduana: Meduanae  # la Mayenne
Meldus: Meledus Meldensem Melitensim Meldensi Meldensim Mel # Meaux
Melitensis: Melitensim # Méallet
Memmatinsis: Memmatinsis # Mende
Meroliacensis: Meroliacensae Meroliacensis # Merliac/Chastel-Marlhac
Mettensis: Mettensis Mettensim Metinsis Metensem Mettinsem Metensim Metinsim Mittense # Metz
Mimate: Mimate # Mende
Mintius: Mintium # Mincio
Momotiacensis: Momotiacensis Mogontiacum # Mayence/Mouzon
Musella: Musella Musellam # Moselle
Mustiae: Mustias #?

Namnetas: Namnetas Namnetico Namneticam Namneticis Namneticum Namneticae Namnitico Namneticos Namneticorum # Nantes
Narbona: Narbonam Narbonae Narbonensem Narbonensim # Narbonne
Nemausus: Nemausus Nemausum Nemausensis # Nîmes
Nemptudoro: Nemptudoro # Nanterre
Nevernus: Neverno Nevernensem # Nevers
Nicea: Niceam Nicensim Nicensis # Nice
Nicenum: Niceam Nicenum Nicaene # Nicée
Niger: Nigrem # (mons) Nigremont
Nilus: Nilus Niliculae # Nil
Nineven: Nineven # Ninive
Ninivitarum: Ninivitarum Ninnivitarum # Ninivites
Nisebenus: Nisebenus Nisebeno # Nisibe
Nivisium: Nivisium # Neuss
Nocito: Nocito # Nogent
Novempopulana: Novimpopulanae # Novimpopula
Noviliacus: Noviliacus # Neuilly-le-Brignon
Novigentum: Novigentum # Nogent-sur-Marne

Octavum: Octavum # Ozon
Onestrudis: Onestrudem # Unstrut
Orbaniacush: Orbaniaco # Orbigny
Oscara: Oscarum Oscaram # Ouche
Osser: Osser # Osser

Pannonia: Pannoniis Pannoniae Pannonia # Pannonie
Parius: Parius Phario #
Parisius: Parisius Parisios Pariseus # Parisiens
Parisiaci: Parisiaci Parisiacae Parisiaco Parisiacus Parisiaca Parisiacam Parisiacis
Pathmos: Pathmos # Pathmos
Pectava: Pectava Pectavina Pectavum Pictavus Pectavis Pectavo Pictavi Pectavam Pectavi Pectavos Pectavus Pectavae Pictava Pectavorum # Poitiers
Pectavensis: Pectavensis Pectavense Pectavinse Pictavensis Pictavensi Pectavensi Pectavinsim Pectavensem Pictavinsis Pictavensim Pectavensibus # de Poitiers
Persi: Persi Persida Persas Persarum Persis
Persi-Armeni: Persi-Armeni # Perse Arménie
Petrocoris: Petrocoricae Petrocoricum Petrogoricae Petrogoricum Petrocoricis Petrocoris # Périgueux
Phiahiroth: Phiahiroth # Phiahiroth
Pirinei: Pirineis Pyrenius Pyrenius# Pyrénées
Placentia: Placentiam
Pontico: Ponticonem # Ponthion
Provincia: Provincia Provinciae Provinciam # Provence

Randanensis: Randanensim # Randan
Remus: Remus Remensem Remense Remensim Remensis Rimensium # Reims
Regensis: Regensim # Riez
Rhedonicus: Redonicum Rhedonicus Rhedonicis Redonicam Redonensis # Rennes
Rhenus: Rheu Rhenus Rheno Rhenum # Rhin
Rhodanus: Rhodani Rodano Rhodanus Rhodanum Rodanus Rhodanitica Rhodanitides # Rhône
Rigoialinsim: Rigoialinsim # Reuil?
Rodomago: Rhodomago Rodomago Rotomagensis Rothomagensim Rothomagensis Rothomaginse Rodoialensim Rotoialinsim Rhodomaginsem Rodomaginsem Rhotomaginsem Rhodomagensie Rhodomaginsis # Rouen
Roma: Roma Romam Romae Romanorum Romanam Romanum Romanae Romani Romanis  Romano Romanos # Rome
Romaniacus: Romaniacum # Romagnac
Rosontinse: Rosontinse # Rosson?
Rotomago: Rotomago # Pont-de-Ruan
Rubrum mare: Rubrum Rubro Rubri mare # Mer Rouge
Rutinus: Rutini Rutino Rutinus Rutena Ruteni Rutina Rutinae Rutinam Rutenae Rutenorum Rutenensis # Rodez

Sabaria: Sabariam Sabariae # Sabaria, Stein-am-Anger
Sadducea: Sadduceae # Saducéens
Santonas: Santo/Sorcynas Sanctonas Sanctonici Santonicae Santonico Santonicum Sanctonicae Sanctonicam Sanctonicum Sanctonicis Sanctonicorum # Saintes
Sauriciacus: Sauriciacum # Sorci
Saxones: Saxonis Saxone Saxonibus Saxones Saxo Saxonum Saxenum
Scaldis: Scaldem # Escaut
Scalonum: Scalonum
Scythia: Scyciae # Scythie
Sellensis: Sellensim # Selle
Senachar: Senachar # Sennaar
Septimania: Septimania Septimaneam Septimaniam Septemaniae
Septimina: Septimina Septiminae
Sequana: Sequanam Sygona # la Seine
Sexonas: Sexonas Sessionas Sessonas Sessionica Sessionica Sessionico Sessionici Sessionicae # Soissons
Sicilia: Siciliam # Sicile
Sicionius: Sicionius Siggonis Sicionis # Sicyoniens
Sigarius: Sigarius
Sigusium: Sigusium # Suze
Silvanectis: Silvanectensi Silvanectensim Silvanectensis Silvanectinse Silvanectis # Senlis
Sina: Sina # Sinaï
Sinonica: Sinonicae Synonicum # Sens
Siria: Siriae Syrorum # Syrie
Sisciensis: Sisciensis # de Sissek
Sodomae: Sodomae Sodomis # Sodome
Solonacensis: Solonacensi # Saunay
Spania: Spanias Spaniis Spanis Spaniam # Espagne
Stablo: Stablonem # Estoublon
Stampensis: Stampensim Stampinse # Etampes
Sueborum: Suebi Sueborum Suavorum # Suèves
Sumena: Sumenam # la Somme

Tarabannensis: Tarabannensibus # Térouanes
Tauredunum: Tauredune Taureduno # Tauredune?
Tausiriacus: Tausiriaco # Turé? Toiselay?
Ternoderinsis: Ternoderinsim # ?
Theifalus: Theifalus Theifalorum # Theifales
Thessalonicenses: Thessalonicenses # Thessalonique
Tholosa: Tolosae Tholosano Tholosam Tholosa Tholosae Tholosana Tholosanorum Tolosanis # Toulouse
Thoringus: Thoringis Thoringus Thoringi Thoringiam Thoringia Thoringorum # Thuringe
Thracias: Thracias
Tiberis: Tiberis # le Tibre
Ticinum: Ticinum Ticinensis # Pavie (Italie)
Tolidum: Tolidum Toletum # Tolède
Tornacus: Tornacum Thornacinsis Tornacensis Tornacensi Thornaco # Tournay
Tornomagensis: Tornomagensi
Treiectinsis: Treiectinsem # Maastricht
Treverus: Treverus Treveris Treverorum Treverensis Treveris # Trèves
Tricassinorum: Trecas Tricassinorum Tricassinum # Troyes
Tulbiacensis: Tulbiacensis Tulbiacensim # Tolbiac
Tungrus: Tungrus Tungrorum # Tongres
Turonus: Turonus Thoronus Toronus Toronum Toronicae Toronicis Toronicos Turonicis Toronicam Turonico Toronica Thoronici Turonicum Turonici Thoronica Toronicum Toronici Toronico Toronicus Turonicae Toronice Turonica Turonicus Thoronicae Turonicam TURONENSIS
Tusciae: Tusciae # Toscane

Ucetica: Ucetica Ucecensis # Uzès
Ugernum: Ugernum # Beaucaire
Ulda: Uldam # Oust (rivière)
Urbia: Urbiam rbiensim # Orge

Vabrense: Vabrense Vabrensim # Woëvre
Valentiam: Valentiam # Valence
Vappinsis: Vappinsis # de Gap
Vasatinsis: Vasatinsis Vasatensem Vasatensis # Bazas
Vasconia: Vasconiam Wascones Wasconibus # Gascogne
Vasso: Vasso # temple
Vellavae: Vellavae Villavo Villavis Villavum # Velay
Veneticae: Veneticae Veneticam Vinitico # Vannes
Venitus: Venitus Vinitico # Vannes
Vernaus: Veranus Veranum Vernao # Vernou-sur-Brenne
Vircellis: Vircellis Vercellensim # Verceil
Vicinonia: Vicinoniae Vicinoniam # Vilaine
Victoris: Victoris
Victuriacus: Victuriacum Victuriaci Victuriaco Victuriacense # Vitry
Vienna: Viennae Viennam Viennense Viennensis # Vienne
Vigenna: Vingennam Vigennam # rivière Vienne
Vinciensis: Vinciensis # Vence
Vindocinum: Vindocino # Vendôme
Viridunum: Viridunum Viredunensim Virdunensis Veredunensis Viridunensim Viredunensis Viredunensim Virdunensis Veredunensis Viridunensim Viredunensis Veredunensem Veridunense # Verdun
Visorontia: Visorontiam # Véseronce
Vivariensis: Vivariensim # Vivarais
Vogladensis: Vogladense Vogladinse # Vouglé
Vosagus: Vosagum Vosagensim # Vosges

Wandali: Wandali Wandalorum # Vandales

